#########################################################
#...@.....#.............................................#
#.........#....q........................z...........s...#
#.........#.............................................#
#.........#............############......g..........b...#
#......................#..........#.....................#
#......................#............................q...#
#...s..................#................................#
#########################################################